author,NF,F,NC,Total,F_Ratio
161981,50,0,35,85,0.0
860819,12,1,10,23,0.043478260869565216
207170,343,19,175,537,0.035381750465549346
860315,579,43,298,920,0.04673913043478261
613063,3301,437,1308,5046,0.08660325009908838
126083,1453,138,811,2402,0.05745212323064113
757630,51,4,47,102,0.0392156862745098
291403,360,76,153,589,0.12903225806451613
54576,573,108,344,1025,0.10536585365853658
62185,382,60,191,633,0.0947867298578199
728341,96,9,64,169,0.05325443786982249
450153,375,68,339,782,0.08695652173913043
669734,72,7,47,126,0.05555555555555555
107153,102,0,47,149,0.0
842068,1930,64,986,2980,0.021476510067114093
486072,1049,44,350,1443,0.030492030492030493
501908,141,23,59,223,0.1031390134529148
351873,201,41,119,361,0.11357340720221606
132387,599,62,1575,2236,0.027728085867620753
737121,631,46,466,1143,0.04024496937882765
746189,854,75,367,1296,0.05787037037037037
355703,735,81,282,1098,0.07377049180327869
336432,471,53,267,791,0.06700379266750948
652919,308,33,122,463,0.07127429805615551
282078,59,2,16,77,0.025974025974025976
384073,79,2,29,110,0.01818181818181818
998010,272,12,1733,2017,0.005949429846306396
671789,40,3,36,79,0.0379746835443038
682458,21,0,32,53,0.0
944454,482,40,751,1273,0.031421838177533384
514375,154,13,116,283,0.045936395759717315
78781,33,1,10,44,0.022727272727272728
838615,52,4,21,77,0.05194805194805195
415449,447,18,105,570,0.031578947368421054
860722,2,0,0,2,0.0
145481,1557,202,648,2407,0.08392189447444952
641702,30,1,10,41,0.024390243902439025
263142,5,0,0,5,0.0
875514,829,37,465,1331,0.02779864763335838
251610,9,1,1,11,0.09090909090909091
456105,137,5,36,178,0.028089887640449437
593625,4,0,0,4,0.0
693264,228,17,134,379,0.044854881266490766
365836,49,5,43,97,0.05154639175257732
923778,27,1,6,34,0.029411764705882353
500633,76,8,33,117,0.06837606837606838
318461,56,4,9,69,0.057971014492753624
893070,208,8,149,365,0.021917808219178082
871717,6,0,16,22,0.0
107329,616,47,671,1334,0.03523238380809595
809616,4,1,1,6,0.16666666666666666
224374,42,15,74,131,0.11450381679389313
857020,49,4,231,284,0.014084507042253521
629004,250,65,162,477,0.13626834381551362
58545,121,5,39,165,0.030303030303030304
866059,190,3,95,288,0.010416666666666666
420688,237,5,100,342,0.014619883040935672
923449,57,1,16,74,0.013513513513513514
652454,7,3,5,15,0.2
980573,3,1,4,8,0.125
556717,169,13,242,424,0.030660377358490566
706044,250,22,112,384,0.057291666666666664
989117,60,2,33,95,0.021052631578947368
878516,252,21,164,437,0.04805491990846682
65073,71,2,4,77,0.025974025974025976
427810,9,0,6,15,0.0
522554,676,30,213,919,0.03264417845484222
49021,204,5,98,307,0.016286644951140065
460492,119,9,60,188,0.047872340425531915
186745,5,0,6,11,0.0
263883,24,1,18,43,0.023255813953488372
215989,8,1,18,27,0.037037037037037035
691353,5,1,1,7,0.14285714285714285
661151,785,51,417,1253,0.040702314445331206
352568,3,1,2,6,0.16666666666666666
612665,19,2,37,58,0.034482758620689655
673927,90,7,35,132,0.05303030303030303
564788,7,0,28,35,0.0
954945,1054,116,379,1549,0.07488702388637831
509539,498,36,256,790,0.04556962025316456
513976,44,11,48,103,0.10679611650485436
132602,101,1,40,142,0.007042253521126761
183090,53,2,64,119,0.01680672268907563
972649,20,3,20,43,0.06976744186046512
764790,26,2,10,38,0.05263157894736842
543562,12,6,3,21,0.2857142857142857
106390,51,0,23,74,0.0
574897,6,0,17,23,0.0
20334,116,21,129,266,0.07894736842105263
887183,463,56,134,653,0.08575803981623277
951934,25,0,0,25,0.0
14182,421,15,193,629,0.02384737678855326
202614,184,3,63,250,0.012
682628,456,79,299,834,0.09472422062350119
653797,7,18,22,47,0.3829787234042553
896133,96,5,118,219,0.0228310502283105
935945,6,0,4,10,0.0
340738,827,101,429,1357,0.07442888725128961
550084,1,0,5,6,0.0
565940,571,43,565,1179,0.0364715860899067
649827,0,0,66,66,0.0
907944,42,4,71,117,0.03418803418803419
260173,39,13,24,76,0.17105263157894737
535031,185,22,87,294,0.07482993197278912
193510,5,21,15,41,0.5121951219512195
239635,0,8,5,13,0.6153846153846154
910837,31,4,8,43,0.09302325581395349
681542,8,8,10,26,0.3076923076923077
403411,0,6,4,10,0.6
283192,4,20,10,34,0.5882352941176471
634422,12,0,132,144,0.0
619696,82,14,116,212,0.0660377358490566
889048,27,1,63,91,0.01098901098901099
114222,285,61,183,529,0.11531190926275993
760098,15,8,143,166,0.04819277108433735
666496,74,0,24,98,0.0
603685,23,0,37,60,0.0
223295,26,2,26,54,0.037037037037037035
618,301,30,191,522,0.05747126436781609
61849,0,0,20,20,0.0
766862,1,1,23,25,0.04
123053,337,92,265,694,0.13256484149855907
345355,0,0,5,5,0.0
366028,1,1,6,8,0.125
79285,0,0,14,14,0.0
305706,45,11,69,125,0.088
63805,44,1,57,102,0.00980392156862745
186277,757,33,210,1000,0.033
154115,5,0,4,9,0.0
969826,4,1,6,11,0.09090909090909091
794052,0,0,8,8,0.0
314147,0,0,5,5,0.0
314245,150,25,80,255,0.09803921568627451
902189,2,0,4,6,0.0
553281,974,80,694,1748,0.04576659038901602
758438,3,0,15,18,0.0
91917,35,0,25,60,0.0
382397,0,0,4,4,0.0
209680,4,0,8,12,0.0
754387,20,0,5,25,0.0
823415,58,8,11,77,0.1038961038961039
954121,3,0,6,9,0.0
755932,42,0,8,50,0.0
586250,0,0,1,1,0.0
554737,25,2,81,108,0.018518518518518517
87313,21,1,12,34,0.029411764705882353
460532,61,0,11,72,0.0
114150,108,19,95,222,0.08558558558558559
322279,337,111,227,675,0.16444444444444445
914291,36,4,43,83,0.04819277108433735
885177,83,3,33,119,0.025210084033613446
747489,37,1,54,92,0.010869565217391304
134934,5,0,0,5,0.0
510547,3,0,1,4,0.0
263304,0,0,2,2,0.0
172664,11,8,51,70,0.11428571428571428
343462,46,2,26,74,0.02702702702702703
819527,91,62,48,201,0.30845771144278605
381287,3,2,2,7,0.2857142857142857
823568,3,0,2,5,0.0
877923,72,3,93,168,0.017857142857142856
310854,0,0,4,4,0.0
910119,126,6,168,300,0.02
131555,539,121,587,1247,0.09703287890938252
127517,109,1,17,127,0.007874015748031496
132163,37,0,27,64,0.0
52260,57,34,40,131,0.2595419847328244
828798,26,0,7,33,0.0
305978,75,16,25,116,0.13793103448275862
335031,12,0,33,45,0.0
320250,0,0,1,1,0.0
914581,4,0,5,9,0.0
877328,43,1,32,76,0.013157894736842105
40583,24,1,1,26,0.038461538461538464
244994,9,1,8,18,0.05555555555555555
959721,0,0,1,1,0.0
54850,0,0,1,1,0.0
568466,47,1,86,134,0.007462686567164179
933523,1,0,3,4,0.0
76957,95,5,72,172,0.029069767441860465
516397,314,26,799,1139,0.0228270412642669
823519,0,0,2,2,0.0
675714,80,12,63,155,0.07741935483870968
560442,22,4,106,132,0.030303030303030304
151561,2,0,1,3,0.0
674782,74,0,34,108,0.0
890307,131,7,56,194,0.03608247422680412
976735,36,14,15,65,0.2153846153846154
735197,23,0,20,43,0.0
508347,99,2,14,115,0.017391304347826087
2830,7,1,4,12,0.08333333333333333
704376,0,0,3,3,0.0
917403,6,1,13,20,0.05
542274,4,0,2,6,0.0
648858,1201,222,485,1908,0.11635220125786164
408358,18,0,38,56,0.0
588002,7,0,10,17,0.0
67037,0,0,2,2,0.0
253582,90,1,67,158,0.006329113924050633
901348,0,0,8,8,0.0
72165,62,4,22,88,0.045454545454545456
886452,25,0,12,37,0.0
620119,4,3,8,15,0.2
693362,17,0,12,29,0.0
12166,5,10,5,20,0.5
115958,7,0,2,9,0.0
849894,63,10,55,128,0.078125
584502,36,27,16,79,0.34177215189873417
149577,15,1,2,18,0.05555555555555555
960332,1,0,17,18,0.0
110734,0,0,2,2,0.0
685693,14,0,6,20,0.0
492586,171,0,90,261,0.0
304744,94,8,94,196,0.04081632653061224
874998,67,4,46,117,0.03418803418803419
41094,369,79,205,653,0.12098009188361408
149343,18,1,19,38,0.02631578947368421
575444,76,8,32,116,0.06896551724137931
24965,30,0,19,49,0.0
5784,0,1,1,2,0.5
487691,2,0,2,4,0.0
620959,0,0,2,2,0.0
769264,74,13,39,126,0.10317460317460317
528998,170,12,52,234,0.05128205128205128
69745,33,1,31,65,0.015384615384615385
566522,42,4,25,71,0.056338028169014086
968765,28,0,20,48,0.0
814875,10,15,12,37,0.40540540540540543
960464,75,15,26,116,0.12931034482758622
54230,11,2,13,26,0.07692307692307693
852241,236,36,63,335,0.10746268656716418
371825,10,3,10,23,0.13043478260869565
178894,61,1,17,79,0.012658227848101266
894582,35,4,29,68,0.058823529411764705
708685,3,0,4,7,0.0
282904,36,6,24,66,0.09090909090909091
917147,17,0,59,76,0.0
657948,662,41,472,1175,0.03489361702127659
184085,17,4,12,33,0.12121212121212122
30560,67,30,26,123,0.24390243902439024
423282,5,1,5,11,0.09090909090909091
114144,250,17,107,374,0.045454545454545456
796582,98,5,24,127,0.03937007874015748
729278,186,31,204,421,0.07363420427553444
843251,75,11,28,114,0.09649122807017543
5804,28,6,15,49,0.12244897959183673
827436,9,1,7,17,0.058823529411764705
405413,0,0,4,4,0.0
293968,24,8,6,38,0.21052631578947367
831695,58,4,3,65,0.06153846153846154
413422,3,0,0,3,0.0
355667,1,7,19,27,0.25925925925925924
881993,48,6,46,100,0.06
624638,97,4,127,228,0.017543859649122806
814337,11,0,46,57,0.0
977178,0,0,1,1,0.0
206934,1,2,7,10,0.2
39235,31,1,11,43,0.023255813953488372
527906,27,2,29,58,0.034482758620689655
351995,39,4,48,91,0.04395604395604396
821859,63,10,53,126,0.07936507936507936
855253,60,11,101,172,0.06395348837209303
97599,2,1,15,18,0.05555555555555555
162164,11,2,11,24,0.08333333333333333
353608,2,0,5,7,0.0
245582,51,0,19,70,0.0
881431,0,0,1,1,0.0
532288,3,0,3,6,0.0
817814,202,2,50,254,0.007874015748031496
665363,35,2,17,54,0.037037037037037035
210608,183,13,78,274,0.04744525547445255
202254,2,0,12,14,0.0
509334,0,0,1,1,0.0
265523,6,0,6,12,0.0
249160,40,0,10,50,0.0
704709,2,0,2,4,0.0
870356,36,3,9,48,0.0625
813256,38,6,6,50,0.12
622288,0,0,5,5,0.0
151647,4,0,1,5,0.0
721484,0,0,1,1,0.0
609451,3,0,15,18,0.0
689247,0,0,1,1,0.0
369748,11,3,21,35,0.08571428571428572
27241,137,4,40,181,0.022099447513812154
751644,85,7,48,140,0.05
362837,1,0,2,3,0.0
653923,16,0,2,18,0.0
722152,30,0,2,32,0.0
807257,0,0,2,2,0.0
543361,128,4,17,149,0.026845637583892617
652772,0,0,1,1,0.0
890796,1,0,18,19,0.0
459583,10,0,2,12,0.0
26765,5,0,2,7,0.0
30586,109,3,61,173,0.017341040462427744
402377,64,1,15,80,0.0125
12651,16,1,7,24,0.041666666666666664
859997,0,1,1,2,0.5
645155,56,1,9,66,0.015151515151515152
118201,6,0,6,12,0.0
782330,1,0,2,3,0.0
753210,10,1,0,11,0.09090909090909091
536736,24,0,55,79,0.0
454609,11,1,0,12,0.08333333333333333
940008,18,0,5,23,0.0
153489,137,3,47,187,0.016042780748663103
193377,24,5,2,31,0.16129032258064516
871583,80,2,75,157,0.012738853503184714
11647,17,0,61,78,0.0
270469,2,0,1,3,0.0
178445,38,0,20,58,0.0
288455,4,0,0,4,0.0
836194,23,6,3,32,0.1875
546806,30,0,3,33,0.0
302593,16,0,5,21,0.0
285805,1,0,2,3,0.0
600959,0,0,4,4,0.0
136993,42,3,13,58,0.05172413793103448
474770,45,1,25,71,0.014084507042253521
207247,21,0,7,28,0.0
426439,4,0,0,4,0.0
251789,236,84,64,384,0.21875
611428,81,1,239,321,0.003115264797507788
281729,0,0,1,1,0.0
623235,8,0,1,9,0.0
157271,48,12,8,68,0.17647058823529413
643478,3,0,1,4,0.0
172546,3,7,4,14,0.5
225070,5,0,9,14,0.0
384465,5,1,0,6,0.16666666666666666
801267,10,0,3,13,0.0
367996,0,0,1,1,0.0
411642,0,0,1,1,0.0
504011,6,0,3,9,0.0
254150,163,24,131,318,0.07547169811320754
159407,5,0,15,20,0.0
386448,50,15,33,98,0.15306122448979592
391593,10,0,14,24,0.0
906938,6,0,1,7,0.0
259095,5,0,2,7,0.0
635690,3,0,2,5,0.0
983538,17,1,1,19,0.05263157894736842
916696,2,0,1,3,0.0
599919,5,5,0,10,0.5
874810,14,11,6,31,0.3548387096774194
940847,26,10,4,40,0.25
328113,92,9,26,127,0.07086614173228346
564375,9,0,5,14,0.0
115941,5,1,1,7,0.14285714285714285
236810,51,0,31,82,0.0
516835,70,2,26,98,0.02040816326530612
930830,8,0,2,10,0.0
186056,4,0,0,4,0.0
876951,11,0,8,19,0.0
122214,35,5,12,52,0.09615384615384616
997703,69,24,44,137,0.17518248175182483
361907,13,8,23,44,0.18181818181818182
575688,16,1,6,23,0.043478260869565216
67869,116,6,86,208,0.028846153846153848
688495,5,0,6,11,0.0
759067,2,1,7,10,0.1
933306,26,5,15,46,0.10869565217391304
563559,37,2,26,65,0.03076923076923077
585980,2,0,11,13,0.0
716027,39,9,30,78,0.11538461538461539
924789,2,0,1,3,0.0
43845,4,0,3,7,0.0
533145,23,0,50,73,0.0
247911,51,1,23,75,0.013333333333333334
766063,3,3,6,12,0.25
326109,1,0,1,2,0.0
375041,2,0,4,6,0.0
379834,2,0,2,4,0.0
649807,0,0,2,2,0.0
765754,10,2,9,21,0.09523809523809523
404965,7,0,1,8,0.0
15595,19,0,10,29,0.0
561261,24,0,6,30,0.0
871565,17,0,9,26,0.0
865325,2,0,2,4,0.0
985539,0,0,1,1,0.0
961504,3,0,0,3,0.0
914618,5,2,11,18,0.1111111111111111
80271,115,3,80,198,0.015151515151515152
395404,1,0,1,2,0.0
203699,12,0,6,18,0.0
149181,11,0,2,13,0.0
711102,1,0,0,1,0.0
672483,2,1,0,3,0.3333333333333333
513780,5,0,0,5,0.0
115072,4,0,0,4,0.0
861239,6,0,5,11,0.0
462645,16,1,3,20,0.05
540,3,0,9,12,0.0
784758,18,0,9,27,0.0
372962,5,0,0,5,0.0
585241,1,3,1,5,0.6
528340,4,1,0,5,0.2
885324,30,1,18,49,0.02040816326530612
474365,6,2,1,9,0.2222222222222222
753144,6,4,5,15,0.26666666666666666
345105,0,11,0,11,1.0
793047,0,0,60,60,0.0
585361,66,13,37,116,0.11206896551724138
197900,58,0,20,78,0.0
587122,10,0,10,20,0.0
83396,4,0,3,7,0.0
932781,5,0,4,9,0.0
62499,10,4,15,29,0.13793103448275862
462939,0,0,5,5,0.0
162151,0,0,2,2,0.0
983477,1,0,3,4,0.0
456813,6,0,2,8,0.0
561929,0,5,7,12,0.4166666666666667
788125,133,13,54,200,0.065
388105,6,0,0,6,0.0
87719,1,0,0,1,0.0
936644,0,1,3,4,0.25
482827,7,0,0,7,0.0
848847,8,0,11,19,0.0
348389,10,7,12,29,0.2413793103448276
54129,24,3,8,35,0.08571428571428572
306191,29,1,4,34,0.029411764705882353
249043,0,0,2,2,0.0
24558,5,0,2,7,0.0
514926,20,3,2,25,0.12
336822,6,3,3,12,0.25
807977,0,4,1,5,0.8
774588,74,13,232,319,0.04075235109717868
939533,1,1,0,2,0.5
928302,7,0,0,7,0.0
773930,11,0,0,11,0.0
873988,1,0,0,1,0.0
942230,10,0,2,12,0.0
114872,18,0,2,20,0.0
117864,11,9,2,22,0.4090909090909091
2061,3,5,3,11,0.45454545454545453
758130,41,0,16,57,0.0
386472,65,2,20,87,0.022988505747126436
509906,70,15,18,103,0.14563106796116504
46717,35,11,3,49,0.22448979591836735
755792,180,11,117,308,0.03571428571428571
389569,19,3,2,24,0.125
813625,5,0,0,5,0.0
285958,5,9,2,16,0.5625
352420,11,0,4,15,0.0
330107,3,0,0,3,0.0
389351,1,0,0,1,0.0
248623,11,0,1,12,0.0
456292,9,0,10,19,0.0
810683,12,0,19,31,0.0
52158,2,0,0,2,0.0
229646,1,0,0,1,0.0
836639,97,1,28,126,0.007936507936507936
329085,2,0,4,6,0.0
201499,2,0,0,2,0.0
416139,22,0,115,137,0.0
324425,162,2,120,284,0.007042253521126761
152860,13,0,1,14,0.0
510573,5,0,0,5,0.0
934893,11,0,6,17,0.0
578296,4,1,0,5,0.2
835396,7,0,0,7,0.0
341534,4,0,3,7,0.0
430438,4,0,2,6,0.0
35111,3,0,0,3,0.0
205134,18,0,8,26,0.0
129134,0,0,2,2,0.0
108005,151,5,88,244,0.020491803278688523
30771,8,0,6,14,0.0
556660,13,0,22,35,0.0
606058,3,12,3,18,0.6666666666666666
172024,4,0,0,4,0.0
576295,14,6,15,35,0.17142857142857143
115700,4,0,0,4,0.0
946705,2,0,7,9,0.0
671680,1,0,1,2,0.0
775350,40,2,15,57,0.03508771929824561
176977,1,0,0,1,0.0
352863,6,0,0,6,0.0
164597,1,0,0,1,0.0
32798,6,0,0,6,0.0
246941,8,0,0,8,0.0
741096,1,0,0,1,0.0
608932,17,0,3,20,0.0
261444,13,0,3,16,0.0
308732,4,0,0,4,0.0
223072,1,0,0,1,0.0
595730,2,0,1,3,0.0
734678,15,0,1,16,0.0
692399,11,2,0,13,0.15384615384615385
625925,14,2,3,19,0.10526315789473684
310360,78,11,46,135,0.08148148148148149
950657,21,1,8,30,0.03333333333333333
205215,6,0,4,10,0.0
187385,4,1,3,8,0.125
347347,3,0,1,4,0.0
765014,5,0,2,7,0.0
8931,3,0,2,5,0.0
792650,2,0,1,3,0.0
946289,2,0,0,2,0.0
256541,2,0,0,2,0.0
879310,2,1,0,3,0.3333333333333333
915091,25,3,5,33,0.09090909090909091
97361,9,0,6,15,0.0
267039,5,0,0,5,0.0
174811,14,0,1,15,0.0
776166,0,0,1,1,0.0
466324,4,0,1,5,0.0
213597,2,0,1,3,0.0
826792,4,0,0,4,0.0
189421,2,0,0,2,0.0
499601,2,0,0,2,0.0
71298,58,0,53,111,0.0
806870,11,0,9,20,0.0
456549,0,3,0,3,1.0
217509,7,0,2,9,0.0
657260,21,1,3,25,0.04
673429,6,0,1,7,0.0
488757,61,1,23,85,0.011764705882352941
199824,1,0,0,1,0.0
405704,2,0,0,2,0.0
129637,27,0,30,57,0.0
154946,24,4,3,31,0.12903225806451613
177402,7,0,0,7,0.0
103836,2,0,0,2,0.0
920378,4,0,0,4,0.0
305963,9,0,2,11,0.0
100022,3,7,9,19,0.3684210526315789
262522,0,0,2,2,0.0
441610,6,2,2,10,0.2
684468,0,0,1,1,0.0
372280,1,0,0,1,0.0
678353,4,0,0,4,0.0
408368,0,1,0,1,1.0
229261,2,0,0,2,0.0
148657,1,2,0,3,0.6666666666666666
946002,218,1,86,305,0.003278688524590164
734935,0,0,15,15,0.0
514555,7,0,0,7,0.0
428714,45,3,8,56,0.05357142857142857
934870,1,0,1,2,0.0
675672,3,0,0,3,0.0
454071,3,0,1,4,0.0
723174,6,0,0,6,0.0
733108,0,0,1,1,0.0
961848,14,0,0,14,0.0
185253,1,0,0,1,0.0
693318,165,0,33,198,0.0
857192,0,0,1,1,0.0
838855,4,0,10,14,0.0
751418,0,0,2,2,0.0
182343,1,0,0,1,0.0
729656,45,18,28,91,0.1978021978021978
383222,4,0,2,6,0.0
940951,3,0,0,3,0.0
530878,1,0,0,1,0.0
510230,5,2,2,9,0.2222222222222222
55847,0,0,5,5,0.0
803345,3,0,1,4,0.0
193246,2,0,7,9,0.0
184706,26,0,10,36,0.0
706085,1,0,1,2,0.0
114283,59,0,23,82,0.0
384709,1,0,0,1,0.0
812208,2,0,0,2,0.0
751149,5,0,1,6,0.0
416773,19,0,3,22,0.0
418947,5,0,3,8,0.0
996715,2,0,0,2,0.0
296395,4,0,0,4,0.0
644161,18,0,1,19,0.0
398135,2,5,4,11,0.45454545454545453
410650,5,0,0,5,0.0
578678,0,1,0,1,1.0
456371,2,0,0,2,0.0
511507,1,0,0,1,0.0
922122,2,0,2,4,0.0
457821,12,1,4,17,0.058823529411764705
757953,25,0,9,34,0.0
165144,1,0,0,1,0.0
723057,2,0,0,2,0.0
848673,1,0,0,1,0.0
735872,3,0,0,3,0.0
459205,22,1,13,36,0.027777777777777776
85154,1,0,0,1,0.0
346383,8,0,0,8,0.0
269517,2,0,0,2,0.0
88861,7,6,1,14,0.42857142857142855
92595,5,0,6,11,0.0
348758,0,0,3,3,0.0
878563,6,0,1,7,0.0
76932,0,0,2,2,0.0
984974,4,0,4,8,0.0
313090,4,0,0,4,0.0
986510,5,0,8,13,0.0
815174,10,0,0,10,0.0
3566,3,0,2,5,0.0
950734,3,1,1,5,0.2
103749,1,0,2,3,0.0
971628,3,0,15,18,0.0
152434,0,1,0,1,1.0
217241,1,0,0,1,0.0
826178,2,0,0,2,0.0
462328,1,0,3,4,0.0
563950,1,0,0,1,0.0
23954,4,0,0,4,0.0
302214,136,4,89,229,0.017467248908296942
823602,50,7,13,70,0.1
280186,14,3,4,21,0.14285714285714285
596501,1,1,1,3,0.3333333333333333
758714,26,0,29,55,0.0
735409,92,2,52,146,0.0136986301369863
941214,1,0,0,1,0.0
978714,33,21,8,62,0.3387096774193548
875160,23,3,0,26,0.11538461538461539
100276,202,51,99,352,0.14488636363636365
461838,3,0,0,3,0.0
261162,1,0,0,1,0.0
81149,28,14,12,54,0.25925925925925924
859547,3,0,0,3,0.0
995542,1,0,0,1,0.0
498004,3,0,3,6,0.0
412005,13,1,2,16,0.0625
366820,8,4,1,13,0.3076923076923077
185571,4,0,0,4,0.0
989260,1,0,0,1,0.0
742578,7,0,0,7,0.0
523328,1,0,0,1,0.0
458591,5,1,2,8,0.125
712746,4,2,1,7,0.2857142857142857
20487,6,8,1,15,0.5333333333333333
729147,10,0,6,16,0.0
71262,0,1,0,1,1.0
377445,3,0,0,3,0.0
424448,5,0,0,5,0.0
133780,1,1,0,2,0.5
226512,0,2,0,2,1.0
108636,14,0,1,15,0.0
534938,4,16,12,32,0.5
766843,4,0,0,4,0.0
436780,3,0,0,3,0.0
711200,1,0,0,1,0.0
697999,1,1,0,2,0.5
778787,5,0,0,5,0.0
368093,2,0,0,2,0.0
616457,5,0,3,8,0.0
390975,4,0,0,4,0.0
470070,5,0,2,7,0.0
749014,2,0,0,2,0.0
971102,4,1,1,6,0.16666666666666666
178823,20,3,8,31,0.0967741935483871
989010,2,0,3,5,0.0
935957,0,1,0,1,1.0
117604,8,0,3,11,0.0
479383,128,13,90,231,0.05627705627705628
615470,55,2,16,73,0.0273972602739726
639336,45,2,10,57,0.03508771929824561
410408,18,0,4,22,0.0
347714,6,1,0,7,0.14285714285714285
474248,12,1,5,18,0.05555555555555555
275982,3,0,0,3,0.0
505711,3,0,0,3,0.0
397892,0,0,1,1,0.0
997881,0,3,1,4,0.75
710059,119,60,149,328,0.18292682926829268
282104,38,0,19,57,0.0
615206,15,0,13,28,0.0
740002,1,0,0,1,0.0
661603,14,0,4,18,0.0
528452,4,0,0,4,0.0
932763,0,0,1,1,0.0
282805,35,0,12,47,0.0
974401,5,0,0,5,0.0
735304,4,0,5,9,0.0
71931,3,0,6,9,0.0
678229,2,0,0,2,0.0
797099,0,0,1,1,0.0
45661,5,0,3,8,0.0
293274,0,0,1,1,0.0
111897,7,0,7,14,0.0
86856,0,0,5,5,0.0
73736,1,0,0,1,0.0
449120,1,0,2,3,0.0
105049,0,1,2,3,0.3333333333333333
893998,2,0,0,2,0.0
115726,2,0,0,2,0.0
791236,1,0,1,2,0.0
589983,5,0,1,6,0.0
738623,3,0,0,3,0.0
418376,6,14,9,29,0.4827586206896552
756218,17,1,29,47,0.02127659574468085
222017,33,0,3,36,0.0
643015,7,1,2,10,0.1
269246,8,0,20,28,0.0
856828,6,0,1,7,0.0
357612,0,0,1,1,0.0
879429,3,0,1,4,0.0
985849,1,0,0,1,0.0
472825,14,0,3,17,0.0
944660,1,0,0,1,0.0
588755,11,0,1,12,0.0
231244,4,5,0,9,0.5555555555555556
943027,0,4,0,4,1.0
457228,1,3,0,4,0.75
245260,1,0,1,2,0.0
215017,5,0,0,5,0.0
616179,7,0,1,8,0.0
698233,25,0,3,28,0.0
646584,5,0,1,6,0.0
770367,2,0,0,2,0.0
623742,0,1,0,1,1.0
899951,9,0,30,39,0.0
551665,4,0,2,6,0.0
730603,6,6,1,13,0.46153846153846156
992974,2,0,4,6,0.0
679401,1,0,1,2,0.0
349323,0,0,1,1,0.0
620376,17,0,2,19,0.0
839472,0,9,8,17,0.5294117647058824
461107,6,3,10,19,0.15789473684210525
600900,0,0,3,3,0.0
524041,94,2,82,178,0.011235955056179775
282432,1,2,1,4,0.5
343294,40,0,9,49,0.0
815665,8,0,5,13,0.0
299640,8,0,4,12,0.0
160273,3,0,3,6,0.0
741372,8,0,9,17,0.0
30561,9,2,7,18,0.1111111111111111
845713,6,0,2,8,0.0
587988,3,0,2,5,0.0
521586,57,11,7,75,0.14666666666666667
123744,31,0,9,40,0.0
589149,8,0,3,11,0.0
370557,0,0,1,1,0.0
727597,9,0,0,9,0.0
892693,1,0,0,1,0.0
237805,25,0,5,30,0.0
844543,4,1,1,6,0.16666666666666666
98425,3,0,0,3,0.0
898015,1,0,0,1,0.0
789129,4,0,2,6,0.0
390926,1,0,0,1,0.0
878090,1,0,1,2,0.0
317048,2,0,0,2,0.0
3736,3,0,0,3,0.0
161489,1,0,0,1,0.0
94934,0,0,3,3,0.0
179991,0,0,6,6,0.0
145589,3,0,5,8,0.0
294695,4,0,0,4,0.0
840121,1,0,0,1,0.0
965148,5,0,1,6,0.0
369018,1,0,0,1,0.0
802957,0,0,5,5,0.0
346681,7,0,2,9,0.0
852469,4,0,0,4,0.0
810434,6,0,0,6,0.0
786395,17,0,6,23,0.0
482964,23,0,4,27,0.0
77552,4,0,1,5,0.0
264162,2,0,0,2,0.0
332022,1,3,0,4,0.75
465509,1,0,0,1,0.0
17626,5,0,7,12,0.0
201237,4,0,6,10,0.0
466056,1,0,2,3,0.0
902884,1,0,2,3,0.0
761466,0,0,3,3,0.0
585395,0,0,1,1,0.0
294977,1,0,0,1,0.0
351626,1,0,0,1,0.0
422099,0,0,2,2,0.0
172911,0,0,1,1,0.0
851712,1,0,9,10,0.0
102957,5,0,3,8,0.0
295383,0,0,2,2,0.0
602618,13,5,15,33,0.15151515151515152
667348,5,5,4,14,0.35714285714285715
337158,14,0,3,17,0.0
843590,0,6,3,9,0.6666666666666666
595781,1,0,0,1,0.0
856785,1,0,0,1,0.0
954313,2,0,5,7,0.0
382994,1,0,0,1,0.0
859817,3,0,0,3,0.0
618184,4,0,1,5,0.0
664729,37,3,24,64,0.046875
921494,5,12,6,23,0.5217391304347826
706949,35,0,13,48,0.0
249567,1,0,0,1,0.0
563091,3,0,1,4,0.0
242,0,0,1,1,0.0
407896,44,4,17,65,0.06153846153846154
435390,7,0,1,8,0.0
827076,24,0,3,27,0.0
619099,2,0,5,7,0.0
950650,6,1,2,9,0.1111111111111111
433517,18,1,30,49,0.02040816326530612
896630,1,0,1,2,0.0
926099,5,0,0,5,0.0
430742,5,1,2,8,0.125
206419,21,0,8,29,0.0
740266,107,4,62,173,0.023121387283236993
124330,1,0,0,1,0.0
122888,4,0,0,4,0.0
722706,11,6,1,18,0.3333333333333333
571407,0,0,5,5,0.0
814859,1,0,0,1,0.0
637494,2,0,0,2,0.0
374061,1,0,1,2,0.0
705681,6,0,0,6,0.0
455016,6,0,0,6,0.0
533805,11,0,3,14,0.0
921184,37,0,6,43,0.0
329876,1,0,0,1,0.0
616763,1,0,0,1,0.0
751463,1,0,0,1,0.0
957177,1,0,0,1,0.0
53539,1,0,0,1,0.0
535512,6,0,0,6,0.0
803123,1,0,0,1,0.0
917356,2,0,1,3,0.0
720615,1,0,0,1,0.0
615203,2,0,0,2,0.0
529672,4,0,0,4,0.0
650054,2,0,0,2,0.0
754563,27,0,1,28,0.0
677812,5,5,4,14,0.35714285714285715
216823,4,2,1,7,0.2857142857142857
206653,1,0,0,1,0.0
236842,8,0,0,8,0.0
228965,16,0,2,18,0.0
329898,2,0,0,2,0.0
76327,8,0,0,8,0.0
976299,37,0,1,38,0.0
677912,5,0,0,5,0.0
274715,58,0,30,88,0.0
145776,3,0,3,6,0.0
551061,1,0,0,1,0.0
525392,3,0,1,4,0.0
683893,1,0,0,1,0.0
664852,1,0,0,1,0.0
379316,1,0,2,3,0.0
911472,4,0,2,6,0.0
426268,3,0,0,3,0.0
756082,8,0,0,8,0.0
692153,1,0,0,1,0.0
822586,9,0,3,12,0.0
506224,3,0,1,4,0.0
792839,4,0,0,4,0.0
401883,0,0,1,1,0.0
127138,8,0,2,10,0.0
384455,5,0,1,6,0.0
854414,1,0,0,1,0.0
834435,1,0,0,1,0.0
436983,6,0,1,7,0.0
712759,5,0,0,5,0.0
519751,7,0,0,7,0.0
723973,10,0,3,13,0.0
263968,2,0,5,7,0.0
276272,10,0,0,10,0.0
989608,12,0,4,16,0.0
736006,15,0,0,15,0.0
440152,12,0,3,15,0.0
99089,5,0,0,5,0.0
417253,38,0,1,39,0.0
814811,15,0,3,18,0.0
327384,0,0,1,1,0.0
310270,4,0,0,4,0.0
286147,23,0,0,23,0.0
519458,14,0,0,14,0.0
40281,137,0,69,206,0.0
173538,0,0,1,1,0.0
547200,46,7,31,84,0.08333333333333333
281608,4,0,4,8,0.0
711331,23,0,5,28,0.0
392452,203,19,110,332,0.0572289156626506
464544,0,2,0,2,1.0
916411,4,0,6,10,0.0
156215,1,0,1,2,0.0
832772,4,0,2,6,0.0
910159,9,2,3,14,0.14285714285714285
957520,10,0,3,13,0.0
271478,9,1,9,19,0.05263157894736842
997317,0,0,1,1,0.0
785349,4,0,1,5,0.0
893629,3,4,0,7,0.5714285714285714
841784,9,1,4,14,0.07142857142857142
651315,0,3,0,3,1.0
105299,2,0,1,3,0.0
743669,2,0,0,2,0.0
132760,2,0,0,2,0.0
308040,0,8,0,8,1.0
817363,1,0,0,1,0.0
839724,1,1,1,3,0.3333333333333333
105833,5,0,1,6,0.0
100958,4,28,9,41,0.6829268292682927
299387,0,0,5,5,0.0
657936,0,0,4,4,0.0
575712,0,0,1,1,0.0
8175,0,0,4,4,0.0
649262,0,0,1,1,0.0
