author,NF,F,NC,Total,F_Ratio
406541,2,0,4,6,0.0
101573,1,0,0,1,0.0
835991,11,0,13,24,0.0
142502,2,0,1,3,0.0
918037,1,0,8,9,0.0
518464,166,42,235,443,0.09480812641083522
435349,729,219,1028,1976,0.11082995951417005
820562,751,75,914,1740,0.04310344827586207
528905,36,3,50,89,0.033707865168539325
914288,307,91,338,736,0.12364130434782608
506702,72,13,185,270,0.04814814814814815
73029,621,125,456,1202,0.10399334442595674
169546,40,0,34,74,0.0
335607,609,162,499,1270,0.12755905511811025
736902,0,0,1,1,0.0
810575,90,123,88,301,0.40863787375415284
773912,8,0,6,14,0.0
142457,394,102,540,1036,0.09845559845559845
426328,181,8,230,419,0.01909307875894988
776678,67,18,75,160,0.1125
143025,164,14,67,245,0.05714285714285714
299478,30,6,27,63,0.09523809523809523
221197,155,0,84,239,0.0
429044,684,71,591,1346,0.05274888558692422
388977,180,12,102,294,0.04081632653061224
239251,528,118,343,989,0.11931243680485339
343091,36,1,10,47,0.02127659574468085
245026,17,0,9,26,0.0
528810,25,0,3,28,0.0
277983,8,0,7,15,0.0
251479,29,2,7,38,0.05263157894736842
255610,2,0,0,2,0.0
726832,201,19,66,286,0.06643356643356643
401184,265,40,198,503,0.07952286282306163
814125,3,0,1,4,0.0
239543,366,101,293,760,0.13289473684210526
41760,3,0,1,4,0.0
158962,258,13,160,431,0.030162412993039442
697484,5,0,3,8,0.0
695155,34,3,14,51,0.058823529411764705
284983,154,11,60,225,0.04888888888888889
933689,12,6,28,46,0.13043478260869565
489689,87,13,106,206,0.06310679611650485
205255,58,6,258,322,0.018633540372670808
505831,127,11,75,213,0.051643192488262914
670486,431,27,299,757,0.035667107001321
110195,228,18,198,444,0.04054054054054054
649175,4,0,0,4,0.0
739775,18,3,28,49,0.061224489795918366
444377,93,17,204,314,0.054140127388535034
741232,2,0,1,3,0.0
568286,1500,436,1039,2975,0.1465546218487395
549329,162,36,100,298,0.12080536912751678
503647,35,10,172,217,0.04608294930875576
416238,186,50,276,512,0.09765625
276725,42,0,4,46,0.0
333320,4,0,18,22,0.0
848907,24,8,19,51,0.1568627450980392
452416,0,0,1,1,0.0
226388,294,94,578,966,0.09730848861283643
735631,29,16,94,139,0.11510791366906475
548494,155,10,80,245,0.04081632653061224
322374,3,0,3,6,0.0
159525,2,0,16,18,0.0
535532,155,32,208,395,0.0810126582278481
554630,71,8,98,177,0.04519774011299435
949949,245,12,165,422,0.02843601895734597
1380,26,7,19,52,0.1346153846153846
106039,280,148,180,608,0.24342105263157895
556089,184,93,167,444,0.20945945945945946
613291,87,35,72,194,0.18041237113402062
52444,483,30,283,796,0.03768844221105527
19264,620,112,273,1005,0.11144278606965174
563290,47,10,22,79,0.12658227848101267
422033,58,14,69,141,0.09929078014184398
108991,15,0,3,18,0.0
628472,118,1,71,190,0.005263157894736842
317058,2,0,2,4,0.0
434358,408,96,446,950,0.10105263157894737
653803,75,18,23,116,0.15517241379310345
651960,195,10,116,321,0.03115264797507788
218639,14,7,40,61,0.11475409836065574
656798,106,16,161,283,0.05653710247349823
292123,51,0,17,68,0.0
794928,256,34,337,627,0.05422647527910686
478238,6,0,4,10,0.0
958986,2,0,6,8,0.0
401838,15,6,35,56,0.10714285714285714
273368,31,0,13,44,0.0
598515,65,5,83,153,0.032679738562091505
716661,22,0,12,34,0.0
495698,3,5,17,25,0.2
43569,123,2,65,190,0.010526315789473684
315524,391,49,238,678,0.07227138643067847
245832,83,3,37,123,0.024390243902439025
987348,146,102,204,452,0.22566371681415928
163685,78,50,30,158,0.31645569620253167
129852,0,0,2,2,0.0
145779,47,4,18,69,0.057971014492753624
668441,2,0,1,3,0.0
32463,30,0,6,36,0.0
579226,243,62,178,483,0.12836438923395446
503194,0,0,35,35,0.0
210752,46,5,50,101,0.04950495049504951
138354,31,1,4,36,0.027777777777777776
348521,25,5,39,69,0.07246376811594203
241961,249,37,129,415,0.0891566265060241
830620,197,57,192,446,0.12780269058295965
797380,282,103,237,622,0.16559485530546625
577072,8,0,1,9,0.0
323373,280,77,264,621,0.12399355877616747
130519,2,0,0,2,0.0
120679,186,22,129,337,0.06528189910979229
815242,19,0,2,21,0.0
203727,56,0,31,87,0.0
481832,46,0,13,59,0.0
206441,26,2,1,29,0.06896551724137931
686179,254,22,116,392,0.05612244897959184
717285,2,0,0,2,0.0
570321,74,26,62,162,0.16049382716049382
980402,94,1,48,143,0.006993006993006993
809408,19,2,2,23,0.08695652173913043
500846,207,49,121,377,0.129973474801061
663868,65,22,84,171,0.1286549707602339
531568,16,10,42,68,0.14705882352941177
882192,116,23,43,182,0.12637362637362637
180690,186,61,149,396,0.15404040404040403
567113,8,2,1,11,0.18181818181818182
652903,270,48,240,558,0.08602150537634409
718573,29,5,21,55,0.09090909090909091
905512,63,5,25,93,0.053763440860215055
888195,26,1,16,43,0.023255813953488372
917618,4,0,0,4,0.0
11656,11,0,3,14,0.0
379474,123,9,43,175,0.05142857142857143
640049,99,61,96,256,0.23828125
876931,4,0,1,5,0.0
428048,14,0,3,17,0.0
235034,19,3,75,97,0.030927835051546393
661938,45,1,21,67,0.014925373134328358
538417,60,8,116,184,0.043478260869565216
820051,104,31,28,163,0.1901840490797546
192574,62,0,5,67,0.0
180236,9,0,11,20,0.0
393556,7,0,3,10,0.0
765803,21,2,11,34,0.058823529411764705
928726,6,3,1,10,0.3
57708,147,6,74,227,0.02643171806167401
834624,31,0,38,69,0.0
188642,0,0,1,1,0.0
874111,3,0,1,4,0.0
535836,55,11,25,91,0.12087912087912088
160245,10,13,2,25,0.52
565506,0,1,0,1,1.0
636251,1,0,2,3,0.0
990325,15,0,2,17,0.0
712067,13,0,5,18,0.0
866019,27,0,6,33,0.0
628948,1,0,0,1,0.0
208778,24,2,3,29,0.06896551724137931
371291,1,0,2,3,0.0
890776,5,5,3,13,0.38461538461538464
973710,86,3,30,119,0.025210084033613446
510938,21,18,32,71,0.2535211267605634
71629,143,58,167,368,0.15760869565217392
602295,5,17,22,44,0.38636363636363635
766418,50,7,14,71,0.09859154929577464
560261,8,0,17,25,0.0
795968,11,7,7,25,0.28
163182,1,0,2,3,0.0
284079,9,2,5,16,0.125
460827,3,0,0,3,0.0
124348,119,0,63,182,0.0
804983,9,0,13,22,0.0
942098,5,8,21,34,0.23529411764705882
133009,38,21,39,98,0.21428571428571427
218661,13,6,3,22,0.2727272727272727
481529,6,0,22,28,0.0
83047,40,0,16,56,0.0
769003,70,0,44,114,0.0
850589,46,5,18,69,0.07246376811594203
830006,190,54,254,498,0.10843373493975904
159841,49,7,52,108,0.06481481481481481
22900,149,5,56,210,0.023809523809523808
75026,11,1,17,29,0.034482758620689655
555521,5,0,1,6,0.0
571823,5,1,2,8,0.125
944122,70,3,39,112,0.026785714285714284
365488,194,27,173,394,0.06852791878172589
264348,0,0,3,3,0.0
973030,3,0,0,3,0.0
910623,6,3,15,24,0.125
727346,4,0,0,4,0.0
235285,139,19,100,258,0.07364341085271318
224130,3,0,3,6,0.0
440593,102,15,52,169,0.08875739644970414
685540,1,0,0,1,0.0
213349,2,0,0,2,0.0
870865,1,0,0,1,0.0
955721,4,0,3,7,0.0
189892,15,1,6,22,0.045454545454545456
126667,4,0,15,19,0.0
36920,1,1,0,2,0.5
464631,9,0,12,21,0.0
592541,22,0,11,33,0.0
37309,4,0,0,4,0.0
939031,63,1,45,109,0.009174311926605505
361527,4,0,0,4,0.0
845909,81,5,48,134,0.03731343283582089
447056,1,0,0,1,0.0
132396,18,0,59,77,0.0
848472,12,0,6,18,0.0
825646,15,2,1,18,0.1111111111111111
785546,2,0,0,2,0.0
160285,0,0,3,3,0.0
,7,0,4,11,0.0
342737,26,3,24,53,0.05660377358490566
525528,17,14,12,43,0.32558139534883723
82722,0,0,1,1,0.0
799375,4,0,2,6,0.0
260243,0,1,9,10,0.1
202516,7,0,4,11,0.0
711203,181,26,220,427,0.06088992974238876
217454,35,8,12,55,0.14545454545454545
830673,61,3,26,90,0.03333333333333333
12426,112,40,64,216,0.18518518518518517
86135,2,7,8,17,0.4117647058823529
239533,4,1,5,10,0.1
946493,29,3,21,53,0.05660377358490566
846380,4,2,7,13,0.15384615384615385
414432,45,0,22,67,0.0
518568,73,93,138,304,0.3059210526315789
764461,8,0,11,19,0.0
575244,174,15,139,328,0.04573170731707317
992207,30,3,9,42,0.07142857142857142
467825,6,12,7,25,0.48
287865,16,11,21,48,0.22916666666666666
477217,36,19,52,107,0.17757009345794392
303624,49,15,85,149,0.10067114093959731
646172,25,5,7,37,0.13513513513513514
626555,126,26,44,196,0.1326530612244898
413644,2,0,11,13,0.0
171330,112,24,154,290,0.08275862068965517
492941,73,2,131,206,0.009708737864077669
180489,5,0,11,16,0.0
193816,111,15,96,222,0.06756756756756757
295803,1,1,2,4,0.25
213671,8,0,10,18,0.0
388912,8,2,9,19,0.10526315789473684
864136,0,0,1,1,0.0
253295,80,7,69,156,0.04487179487179487
288813,5,9,14,28,0.32142857142857145
524807,12,4,3,19,0.21052631578947367
829914,10,6,5,21,0.2857142857142857
961021,46,5,29,80,0.0625
281934,27,18,22,67,0.26865671641791045
874807,29,0,51,80,0.0
39036,5,1,2,8,0.125
566317,2,0,0,2,0.0
909976,0,2,2,4,0.5
673322,3,0,0,3,0.0
856060,6,2,4,12,0.16666666666666666
927484,1,0,2,3,0.0
442140,5,0,0,5,0.0
348971,109,14,99,222,0.06306306306306306
353084,2,0,19,21,0.0
702273,14,32,20,66,0.48484848484848486
704795,0,1,11,12,0.08333333333333333
801309,18,4,15,37,0.10810810810810811
207192,42,53,33,128,0.4140625
948758,18,2,43,63,0.031746031746031744
643366,3,0,11,14,0.0
590242,2,0,0,2,0.0
89562,3,0,2,5,0.0
651789,2,0,0,2,0.0
532698,12,1,2,15,0.06666666666666667
421256,3,0,3,6,0.0
702390,166,44,139,349,0.12607449856733524
776316,95,29,40,164,0.17682926829268292
119610,0,0,2,2,0.0
942074,1,0,0,1,0.0
899865,62,55,29,146,0.3767123287671233
410709,0,0,8,8,0.0
542607,10,0,16,26,0.0
735956,10,9,6,25,0.36
174460,31,36,18,85,0.4235294117647059
299059,2,0,4,6,0.0
62588,1,0,1,2,0.0
284397,1,0,1,2,0.0
233365,1,0,0,1,0.0
705736,2,0,2,4,0.0
589729,59,0,34,93,0.0
395164,2,0,0,2,0.0
599893,4,0,0,4,0.0
2376,5,0,6,11,0.0
654592,2,24,0,26,0.9230769230769231
663697,200,84,112,396,0.21212121212121213
5667,7,3,9,19,0.15789473684210525
304175,0,0,2,2,0.0
623853,1,0,1,2,0.0
285789,5,0,8,13,0.0
177313,0,6,27,33,0.18181818181818182
39110,16,0,4,20,0.0
170781,9,0,11,20,0.0
289495,6,0,1,7,0.0
258713,11,0,6,17,0.0
459331,20,3,7,30,0.1
292237,6,0,1,7,0.0
715338,78,2,37,117,0.017094017094017096
721459,40,3,5,48,0.0625
253509,1,0,0,1,0.0
47587,2,0,1,3,0.0
884803,25,0,10,35,0.0
674120,12,0,0,12,0.0
234778,6,0,1,7,0.0
344425,15,0,3,18,0.0
350602,2,0,0,2,0.0
819182,4,0,0,4,0.0
25879,2,0,3,5,0.0
772338,5,0,3,8,0.0
518785,7,2,5,14,0.14285714285714285
252041,1,0,2,3,0.0
938209,8,1,4,13,0.07692307692307693
633756,0,0,31,31,0.0
767022,27,13,11,51,0.2549019607843137
655538,22,1,5,28,0.03571428571428571
397444,1,0,3,4,0.0
533392,4,0,0,4,0.0
504787,1,0,0,1,0.0
639856,1,0,0,1,0.0
79206,7,0,1,8,0.0
544776,1,2,0,3,0.6666666666666666
757221,40,19,19,78,0.24358974358974358
5391,0,1,4,5,0.2
868135,9,0,2,11,0.0
561329,8,0,5,13,0.0
869646,18,0,2,20,0.0
52357,15,0,1,16,0.0
701630,10,10,11,31,0.3225806451612903
406067,3,0,0,3,0.0
210762,25,0,17,42,0.0
359033,1,0,0,1,0.0
596974,2,0,10,12,0.0
448637,8,0,0,8,0.0
742469,3,0,0,3,0.0
460009,4,0,0,4,0.0
318537,3,0,0,3,0.0
212724,0,0,2,2,0.0
223043,15,0,40,55,0.0
244749,3,6,2,11,0.5454545454545454
742817,0,0,1,1,0.0
516552,1,0,7,8,0.0
930010,1,0,0,1,0.0
843254,4,0,0,4,0.0
186307,1,0,0,1,0.0
116289,10,0,16,26,0.0
281766,0,0,6,6,0.0
787254,0,0,12,12,0.0
42568,4,0,1,5,0.0
496475,8,0,2,10,0.0
890413,17,15,20,52,0.28846153846153844
892366,1,3,0,4,0.75
350777,6,2,3,11,0.18181818181818182
268722,0,2,0,2,1.0
906509,13,2,3,18,0.1111111111111111
731772,1,0,0,1,0.0
77363,3,0,0,3,0.0
133323,6,2,0,8,0.25
333293,0,0,1,1,0.0
183092,1,0,1,2,0.0
908702,2,0,2,4,0.0
930062,1,0,0,1,0.0
972675,14,0,2,16,0.0
397569,2,0,2,4,0.0
557137,1,0,0,1,0.0
700247,1,0,0,1,0.0
841288,5,2,0,7,0.2857142857142857
109787,21,2,14,37,0.05405405405405406
395111,1,0,0,1,0.0
107854,1,0,0,1,0.0
330240,1,0,0,1,0.0
183606,3,0,1,4,0.0
623608,2,0,2,4,0.0
259498,0,0,1,1,0.0
740147,1,0,1,2,0.0
910366,2,0,1,3,0.0
753210,26,1,9,36,0.027777777777777776
997237,1,0,0,1,0.0
186245,21,0,4,25,0.0
562321,2,0,0,2,0.0
915511,3,0,0,3,0.0
383093,2,0,0,2,0.0
757460,20,0,11,31,0.0
2774,0,0,1,1,0.0
250590,1,0,0,1,0.0
495608,4,0,0,4,0.0
647169,5,0,0,5,0.0
124147,1,0,1,2,0.0
620475,12,10,5,27,0.37037037037037035
983171,8,0,0,8,0.0
699719,4,0,0,4,0.0
722218,9,0,2,11,0.0
270953,1,0,0,1,0.0
349416,1,0,0,1,0.0
755932,3,0,2,5,0.0
558018,0,0,1,1,0.0
972363,0,1,0,1,1.0
838582,1,0,2,3,0.0
676439,29,2,14,45,0.044444444444444446
996625,2,0,3,5,0.0
89865,0,1,1,2,0.5
515522,1,0,2,3,0.0
56547,0,0,2,2,0.0
795145,16,0,14,30,0.0
731092,1,0,10,11,0.0
198722,23,12,1,36,0.3333333333333333
996083,0,0,6,6,0.0
262060,9,0,11,20,0.0
918811,12,3,2,17,0.17647058823529413
638072,0,0,2,2,0.0
631338,1,0,0,1,0.0
4323,1,0,1,2,0.0
521135,15,0,3,18,0.0
362729,1,0,2,3,0.0
834847,3,0,0,3,0.0
217373,2,0,0,2,0.0
462107,1,0,0,1,0.0
29333,2,0,1,3,0.0
258499,1,0,0,1,0.0
198066,0,2,0,2,1.0
595864,1,0,0,1,0.0
677096,4,0,0,4,0.0
66951,0,0,2,2,0.0
314043,2,0,0,2,0.0
774939,11,0,12,23,0.0
555638,3,5,1,9,0.5555555555555556
90237,0,0,6,6,0.0
954207,2,0,0,2,0.0
701329,0,0,1,1,0.0
92911,4,0,0,4,0.0
821182,0,0,1,1,0.0
373434,0,0,14,14,0.0
788331,14,0,2,16,0.0
697498,1,0,1,2,0.0
145247,0,0,1,1,0.0
520418,18,0,1,19,0.0
134254,3,0,0,3,0.0
582354,0,0,2,2,0.0
410943,0,0,1,1,0.0
721891,0,3,0,3,1.0
218763,0,2,0,2,1.0
395216,1,4,1,6,0.6666666666666666
689785,1,2,0,3,0.6666666666666666
278169,4,0,0,4,0.0
92632,7,2,2,11,0.18181818181818182
831715,47,14,20,81,0.1728395061728395
854374,4,0,0,4,0.0
816053,0,0,1,1,0.0
984238,1,0,1,2,0.0
835642,0,0,28,28,0.0
857382,39,10,23,72,0.1388888888888889
366345,10,2,7,19,0.10526315789473684
328550,2,0,4,6,0.0
472003,1,0,0,1,0.0
406404,2,0,3,5,0.0
987140,7,2,10,19,0.10526315789473684
403622,0,7,2,9,0.7777777777777778
261763,4,4,0,8,0.5
636349,16,2,14,32,0.0625
728109,3,1,0,4,0.25
713747,0,6,1,7,0.8571428571428571
174390,6,3,14,23,0.13043478260869565
996755,1,0,0,1,0.0
912986,12,12,8,32,0.375
76463,1,0,0,1,0.0
317803,2,0,0,2,0.0
605087,3,3,1,7,0.42857142857142855
466703,0,9,2,11,0.8181818181818182
377035,0,1,1,2,0.5
995391,1,0,0,1,0.0
265737,1,0,0,1,0.0
893063,0,2,1,3,0.6666666666666666
699780,0,1,2,3,0.3333333333333333
698909,1,0,0,1,0.0
982240,1,0,0,1,0.0
547140,1,0,0,1,0.0
944170,1,0,0,1,0.0
891683,44,1,13,58,0.017241379310344827
697723,0,3,0,3,1.0
184249,3,0,1,4,0.0
282746,7,7,7,21,0.3333333333333333
216142,51,0,46,97,0.0
924996,2,0,0,2,0.0
952709,2,0,0,2,0.0
320278,1,0,0,1,0.0
172817,0,0,1,1,0.0
840876,6,0,3,9,0.0
922026,2,2,2,6,0.3333333333333333
329800,1,1,0,2,0.5
442041,3,3,2,8,0.375
527579,13,0,3,16,0.0
10962,1,0,0,1,0.0
752582,0,0,1,1,0.0
558639,2,0,1,3,0.0
598666,0,1,0,1,1.0
522605,1,0,0,1,0.0
654770,4,0,1,5,0.0
344573,3,0,6,9,0.0
582605,2,0,0,2,0.0
496574,0,5,0,5,1.0
982960,0,1,0,1,1.0
450667,0,0,1,1,0.0
367300,2,0,3,5,0.0
904816,2,0,11,13,0.0
275336,0,0,2,2,0.0
679081,0,0,2,2,0.0
185027,0,0,23,23,0.0
806067,0,0,2,2,0.0
257543,0,0,2,2,0.0
